###############################################################################
#                                                                             #
#                                                                             #
#                                                                             #
#                                                                             #
#                                                                             #
#                                                                             #
#                                                 $                           #
#                                                                             #
#                                                                             #
#                                                                             #
#$                                                                            #
########                                                                      #
#      #                                                                      #
#  $                                                                          #
#      #                                                                      #
########                                                                      #
#                                   $                                         #
#                                                                             #
#                                                                             #
#                                                                             #
#                                                                             #
#                                                                             #
###############################################################################